NO ./assets/xpm/wolfenstein/bluestone.xpm
SO ./assets/xpm/wolfenstein/greystone.xpm
WE ./assets/xpm/wolfenstein/purplestone.xpm
EA ./assets/xpm/wolfenstein/red.xpm

F 129,129,129
C 56,56,56

    111111111111N111111111111
    10000000000000000000000001
    10000000000000000000000001
    10000000000000000000000001
    10000000000000000000000001
    10000000000000000000000001
    10000000000000000000000001
    10000000000000000000000001
    10000000000000000000000001
    10000000000000000000000001
    10000000000000000000000001
    10000000000000000000000001
    10000000000000000000000001
    10000000000000000000000001
    10000000000000000000000001
    10000000000000000000000001
    10000000000000000000000001
    11111111111111111111111111