NO ./assets/xpm/minecraft/wood.xpm      
SO ./assets/xpm/minecraft/wood.xpm
EA ./assets/xpm/minecraft/wood.xpm
WE ./assets/xpm/minecraft/wood.xpm

F 90,108,48
C 110,157,211








 1111  
100001
100001
1000011111111111111111
 1000000000000000001001
 100E0000000000000011111 1 
 1000000000000000001001    1
1000011111111111111111      11111
100001                      100001
100001                      10001  
 1111                       11111