NO ./assets/xpm/wolfenstein/bluestone.xpm
SO ./assets/xpm/wolfenstein/greystone.xpm     
      WE ./assets/xpm/wolfenstein/purplestone.xpm
EA ./assets/xpm/wolfenstein/red.xpm

F      112,      112,112
C     56,       56,56

111111111111111111111111111111
11000001110101011111011110S0111
11111111 1111111 11111111111